R   700  700
    
SO ./map/base/wood.xpm         
EA ./map/base/colorstone.xpm 
WE ./map/base/colorstone.xpm 
NO ./map/base/wood.xpm     

S  ./map/base/spr_zebra.xpm      

F 80,200,150
C 50,150, 250

  1111111111111111111
1111100000000000021
102000002000002011
10000000000000001
100020002000200011111111
1000001111111100000000001
101011        1101111111
111011111111110000011
100000000000000000201111111111
100000000002000000000000000001
100020000000000000000000000001
1000002000000000000N0000000011
1000000020000200000000000001
1000000000000000000000000001
1111111111111111111111111111