R   700 700
	NO            ./map/base/wood.xpm



SO ./map/base/wood.xpm
EA ./map/base/colorstone.xpm
WE ./map/base/greystone.xpm
S ./map/base/spr_portal.xpm


F 90 , 150, 62     
C 25, 25, 25 




         11111111111
        1000000000101
        1020200201001
        10002000010011            1
        1020100201001
        10001100N11011
        1000000000001
        1002222010001         111111
        1000000000001         100001
         11111111111          110001
         1111111111111        111111
    111
    111

